AAA 04 05 01
000
00pp00..
00..0000
..00....
..0000..
0000..xx

AAB 04 04 02
000 001
pp02..00
01020000
0001..00
000200xx