AAA 04 05 02
000 001
00pp00..
00..0000
..00....
..0000..
0000..xx